"filename", "language", "Java", "comment", "blank", "total"
"e:\prog\java\APCS\tank\src\GUI.java", "Java", 19, 0, 3, 22
"e:\prog\java\APCS\tank\src\GameMap.java", "Java", 116, 2, 19, 137
"e:\prog\java\APCS\tank\src\GamePanel.java", "Java", 79, 6, 11, 96
"e:\prog\java\APCS\tank\src\Main.java", "Java", 5, 0, 0, 5
"e:\prog\java\APCS\tank\src\externals\Scalr.java", "Java", 504, 1882, 149, 2535
"e:\prog\java\APCS\tank\src\gameElements\Blks.java", "Java", 10, 0, 0, 10
"e:\prog\java\APCS\tank\src\gameElements\Bullet.java", "Java", 27, 1, 3, 31
"e:\prog\java\APCS\tank\src\gameElements\DestrBlk.java", "Java", 10, 0, 0, 10
"e:\prog\java\APCS\tank\src\gameElements\EmptyBlk.java", "Java", 10, 0, 2, 12
"e:\prog\java\APCS\tank\src\gameElements\GameElement.java", "Java", 75, 2, 17, 94
"e:\prog\java\APCS\tank\src\gameElements\Gun.java", "Java", 32, 1, 8, 41
"e:\prog\java\APCS\tank\src\gameElements\MovableElement.java", "Java", 27, 2, 10, 39
"e:\prog\java\APCS\tank\src\gameElements\SolidBlk.java", "Java", 10, 0, 1, 11
"e:\prog\java\APCS\tank\src\gameElements\Tank.java", "Java", 112, 1, 16, 129
"e:\prog\java\APCS\tank\src\gameElements\Weapons.java", "Java", 74, 0, 19, 93
"e:\prog\java\APCS\tank\src\utils\Consts.java", "Java", 43, 5, 13, 61
"e:\prog\java\APCS\tank\src\utils\Coord.java", "Java", 105, 1, 22, 128
"e:\prog\java\APCS\tank\src\utils\Direct.java", "Java", 62, 0, 1, 63
"e:\prog\java\APCS\tank\src\utils\Helpers.java", "Java", 19, 0, 1, 20
"e:\prog\java\APCS\tank\src\utils\ImagePanel.java", "Java", 150, 25, 32, 207
"Total", "-", 1489, 1928, 327, 3744